111111111
1P0000001
1C1C1C1C1
1C1C1C1C1
1C1C1C1C1
1C1C1C1C1
1C1C1C1C1
1C1C1C1C1
1C1C1C1C1
1C1C1C1C1
1C1C1C1C1
1C1C1C1C1
1C1C1C1C1
1C1C1C1E1
1C1C1C101
111111111
