111111110
10000C001
1P00000E1
111111111
