1111111111111111111111111
1G1G1G1G1111111111G1G1G11
11111111CCCCCCCCCC1111111
1PCCCCCCCCCCCCCCCCCCCCCE1
111111111CCCCCCCCC1111111
1G1G1G1G111111111G1G1G1G1
1111111111111111111111111
