11111111111111111111111111111
1000000000C00000C0000101E1001
10100101001000000100100011101
10100100101010100000000001011
1P0000000C00C00000000000000C1
10000C00000010000000100000001
1000000000000C000000000100001
100000001000C0000000C00000001
1000C00000010000000C000000001
11111111111111111111111111111
