111111111111111111111111111111
10000000000C00000C0000001E1001
101001010010000010010000111101
101001001010101000000000010101
1P0000000C00C000000000000000C1
10000C000000100000001000000001
100000000000C00000000001000001
10000001000C000000000C00000001
1000C0000001000000C00000000001
111111111111111111111111111111